+-+-+-+-+-+-+-+-+-+-+-+-+ +-+-+-+-+-+-+-+-+-+-+-+-+-+-+-+-+-+
!                                       !                   !
+ +-+-+-+-+-+ +-+-+-+-+-+-+-+-+-+-+-+-+ + +-+ +-+-+-+-+ +-+-+
!           !                         !   !           !     !
+ +-+-+-+ +-+ +-+ +-+-+-+-+-+-+-+-+-+-+-+-+-+-+-+-+-+-+-+-+-+
!     !   !     !                                       !   !
+-+ +-+-+-+ +-+-+-+-+ +-+ +-+-+-+-+ +-+-+-+-+-+ +-+ +-+ + +-+
!         !       !   !           !           !   !   !     !
+ +-+-+-+ + +-+-+-+-+-+-+-+-+ +-+-+ +-+ +-+-+ +-+ + + +-+-+ +
!       ! !                 !     !   !     !   ! ! !     ! !
+ +-+-+-+-+ +-+ +-+ +-+-+ +-+-+-+-+ +-+ +-+-+-+-+-+ +-+-+ +-+
!         !   !   !     !       !   !           !       !   !
+-+ +-+ +-+-+-+ + +-+-+-+ +-+-+-+ +-+-+-+-+-+-+ +-+-+-+-+ + +
!     !       ! !       !       !           !           ! ! !
+ +-+-+-+-+ +-+ +-+ +-+-+-+ +-+ +-+ +-+ +-+ +-+-+ +-+-+-+ + +
!         !   !   !       !   !   !   !   ! !           ! ! !
+-+-+-+ +-+-+-+ + + +-+-+-+-+-+-+-+-+-+-+ +-+-+-+-+-+ +-+ +-+
!         !     ! !                   !             !   !   !
+ +-+-+-+ + +-+-+-+-+-+-+-+ +-+-+-+-+ +-+-+-+-+-+-+-+ +-+ +-+
!     !   !               !         !               !   !   !
+ +-+ +-+-+-+-+-+ +-+-+ +-+-+-+ +-+-+-+-+-+ +-+-+ +-+-+ +-+-+
!   !           !     !   !               !   ! ! !         !
+-+ +-+-+-+-+-+-+-+-+-+ +-+ +-+-+ + + + + + + + + +-+-+-+-+-+
!       !         !       !   !   ! ! ! ! ! ! !             !
+ +-+ + + +-+ +-+-+ +-+-+-+-+-+ +-+-+ +-+-+-+-+-+-+ +-+-+-+ +
!   ! ! !   !     !           !   !               !       ! !
+-+ +-+ + +-+-+-+-+ +-+-+-+-+ +-+-+-+-+-+ +-+-+-+-+ +-+-+-+-+
!     !           !         !           !         !         !
+ +-+-+-+-+-+-+ +-+-+-+-+-+ +-+-+-+ +-+-+-+-+ +-+-+-+ + +-+-+
!             !           ! !   !           !       ! !     !
+ +-+-+ +-+-+ +-+-+-+-+-+-+ +-+ +-+-+-+-+-+-+-+-+-+-+ +-+ +-+
!     !     !             !                       ! !   !   !
+ +-+-+ +-+-+-+ +-+-+-+ +-+-+-+-+-+-+-+-+-+ +-+-+-+ +-+ + +-+
!     !       !     !           !         !         !   !   !
+-+ + +-+ + +-+-+-+-+-+-+ + +-+-+ + +-+-+-+-+-+-+-+-+-+-+-+ +
!   ! !   !             ! !       !                   !   ! !
+ +-+ +-+-+-+-+-+-+-+-+-+-+-+-+-+-+-+-+-+-+-+-+-+-+ +-+-+ + +
!   !                                         !         !   !
+ +-+-+-+-+ +-+ +-+-+-+-+-+-+ +-+-+-+-+-+ +-+-+-+-+-+-+-+-+-+
!         !   !     !       !           !                   !
+ +-+-+-+ +-+ +-+ +-+ + + +-+-+-+ +-+-+-+-+-+-+-+ +-+-+-+ +-+
!       ! !     !     ! !     !               !       !     !
+-+ + +-+-+-+-+ +-+-+-+-+-+-+-+ +-+-+-+-+ + +-+-+-+-+-+ +-+-+
!   !         !               !         ! !           !     !
+-+ +-+-+ +-+-+ +-+-+ +-+ + + +-+-+-+-+-+-+-+-+-+-+-+-+-+-+ +
!       !     !     ! !   ! !         !                   ! !
+-+ +-+-+-+ + +-+-+-+-+-+-+ +-+-+ +-+-+ + +-+-+-+-+-+-+-+-+ +
!         ! !             !   !   !     !                 ! !
+ +-+ + +-+ +-+-+-+-+-+-+-+-+-+ +-+ +-+-+-+-+ +-+-+ +-+-+-+ +
!   ! !   !                   !             !     ! !       !
+ +-+-+-+-+-+-+-+-+ +-+-+-+-+-+-+-+-+-+ + +-+ +-+-+-+-+-+-+-+
!                 !               ! !   !   !               !
+ +-+-+-+-+-+ +-+-+-+-+-+ +-+ + +-+ +-+-+-+ +-+-+-+-+ + +-+ +
!           !   !     !   !   !           !         ! ! !   !
+ +-+-+-+ +-+ +-+ +-+-+-+-+-+-+-+-+-+-+-+-+-+-+ +-+-+-+-+-+-+
! !     !   !   !                             !             !
+ + + +-+ +-+ +-+ + + + +-+-+-+ +-+ +-+-+-+-+ + +-+-+-+-+-+-+
!   !   !   !     ! ! !       ! !           ! !             !
+ +-+-+ +-+-+-+-+-+ +-+-+ +-+-+-+-+-+ + +-+ +-+ +-+-+-+-+-+-+
!     !           !     !         !   !   !   !             !
+-+-+-+-+-+-+-+-+-+-+-+-+-+-+-+-+-+-+-+-+-+-+-+-+ +-+-+-+-+-+
