+-+-+-+-+-+-+-+-+-+-+-+-+-+-+-+-+-+-+-+-+-+-+-+-+-+-+ +-+-+-+
!           !                                 !             !
+ +-+-+ + +-+ +-+-+-+-+-+ + + +-+-+-+ +-+-+ +-+ + + +-+-+-+-+
!   !   !               ! ! !       !     !     ! !         !
+-+-+ +-+ +-+-+ +-+-+-+-+-+ + +-+-+-+-+-+ +-+-+-+-+ +-+-+-+-+
!       !     !         !   !           !         !         !
+ +-+-+-+-+ +-+-+-+-+ + + +-+-+-+ +-+ +-+ +-+-+-+-+-+ +-+-+-+
!         !     !     ! !       !   !   !           !       !
+ +-+-+ + + +-+ +-+-+-+-+ + + +-+-+-+ +-+-+ +-+ +-+-+ + +-+-+
!     ! ! ! !           ! ! !       !     !   !   !   !     !
+ +-+ + +-+ + +-+ + +-+ +-+-+-+ +-+-+-+-+-+-+-+-+-+-+-+ + +-+
!   ! !   ! ! !   !   !   !   !                   !     !   !
+-+-+ +-+-+ + +-+-+ +-+-+ + +-+-+-+-+-+-+-+-+-+-+-+ +-+-+-+-+
!         ! !     !     !                         !         !
+-+ +-+ +-+-+-+-+-+ +-+-+-+-+ + + +-+ +-+-+-+-+-+-+ +-+-+ +-+
!   !           !           ! ! !   !             !   !     !
+ +-+ +-+-+-+-+-+ +-+-+-+-+ +-+-+-+ +-+ +-+-+-+-+-+ +-+-+-+-+
!   !           !     !         !     !           !         !
+ + +-+-+-+ +-+-+-+ +-+-+-+-+ + +-+-+-+-+-+-+-+-+-+-+-+-+-+ +
! !       !       !         ! !                           ! !
+-+ +-+-+-+-+ +-+-+-+ +-+-+-+ + +-+-+-+-+-+ +-+-+-+-+ +-+-+ +
!           !     !       !   !           !         !     ! !
+ +-+-+-+-+-+-+ +-+ +-+-+-+-+-+-+-+-+-+-+-+-+-+-+-+-+-+-+-+ +
!             !   !                                     !   !
+ +-+-+-+-+ + +-+-+-+-+-+ +-+-+-+-+ +-+-+-+-+-+-+ +-+-+ + +-+
!       !   !           !     !   !             !   !   !   !
+ +-+-+-+ +-+ + +-+ +-+-+-+ +-+ +-+-+-+-+-+-+-+ +-+-+-+-+ +-+
!     !     ! ! !         !               !   !         !   !
+-+ + +-+-+-+ +-+-+-+-+-+-+-+-+-+ + +-+-+-+ +-+ +-+-+ +-+ +-+
!   !     !                     ! !       !   !     !   !   !
+ +-+-+-+ +-+-+-+-+-+ + +-+-+-+-+ + +-+-+ + + +-+-+-+-+-+ +-+
!       !           ! !         ! !     ! ! !           !   !
+ +-+ +-+ +-+-+-+ +-+-+-+ +-+-+-+-+ +-+-+-+ + +-+-+ +-+-+ +-+
!   !   !   !         !           !         !     !     !   !
+ +-+-+-+-+ +-+-+-+-+-+ +-+-+-+-+ +-+-+-+-+-+ +-+-+-+ +-+ +-+
!         !         !         ! !           !       !   !   !
+ +-+-+-+-+-+-+-+-+-+ +-+-+ + + +-+-+-+-+-+-+-+-+ +-+-+-+ +-+
!                   !     ! !                   !       !   !
+ +-+-+-+-+-+-+-+-+-+-+-+ +-+-+-+-+-+-+-+ +-+ + + + +-+-+ + +
!                       !               !   ! ! ! !     ! ! !
+-+ +-+-+-+-+ +-+-+-+-+-+ +-+ +-+-+-+-+-+-+ +-+-+ +-+-+-+-+-+
!           !         ! !   !           !       !           !
+ +-+-+-+-+-+-+-+-+-+-+ + + +-+-+-+-+-+-+-+-+-+-+ + +-+-+-+-+
!                     !   !                   !   !         !
+ +-+-+ +-+-+-+ +-+-+-+-+-+-+-+ +-+-+-+ +-+ +-+-+-+ +-+-+-+-+
!   !         !               !       !   !       ! !       !
+ +-+-+-+-+-+-+ + +-+-+ +-+-+-+ +-+-+-+ +-+ +-+-+-+ +-+ + +-+
!           !   !     !       !       !   !       !     !   !
+-+ +-+-+-+-+ +-+-+-+-+-+ + +-+-+-+ + + +-+-+-+-+-+-+-+-+-+ +
!           !           ! !       ! ! !                   ! !
+ +-+-+ +-+-+ +-+-+-+ +-+ +-+ +-+-+ + +-+-+-+-+-+-+-+-+-+-+ +
!     !     !       !   !   !     ! !           !         ! !
+ +-+-+-+-+-+ +-+-+-+ +-+-+-+-+-+-+ +-+-+-+-+ + + +-+-+-+-+-+
!       !           !             !     !     !             !
+ +-+-+-+-+-+-+-+-+-+-+-+-+-+-+-+-+-+-+-+ +-+-+-+-+-+-+-+-+-+
!                                       !                   !
+ +-+-+-+ +-+ +-+-+-+-+-+ +-+-+ +-+-+-+-+-+-+-+-+ + + +-+-+ +
!       ! !             !     !       !         ! ! !     ! !
+ +-+-+ + +-+-+-+-+-+-+ + +-+-+-+ +-+-+ +-+-+-+-+-+-+-+ +-+ +
!   !   !         !     !       !                     !   ! !
+-+-+-+-+-+-+-+-+-+-+-+-+-+-+-+-+-+-+ +-+-+-+-+-+-+-+-+-+-+-+
