+-+-+-+-+-+-+-+-+-+-+-+-+-+-+-+ +-+-+-+-+-+-+-+-+-+-+-+-+-+-+
!                                                           !
+ +-+-+ +-+-+-+-+ + +-+-+-+-+-+-+-+ +-+-+-+ +-+ +-+-+-+-+-+ +
!     !         ! !               !       !   !           ! !
+ +-+-+ +-+-+-+-+-+-+-+-+-+ + +-+ + +-+-+-+-+ +-+-+-+-+-+-+ +
!     !                 !   !   ! !         !             ! !
+ +-+ + +-+-+ +-+ +-+ + +-+-+ +-+-+-+ +-+-+-+-+ +-+-+-+-+ +-+
!   ! !     ! !   !   !     !       !         !         !   !
+ +-+-+ + +-+ + +-+-+-+-+ + + +-+ +-+-+-+ + +-+ + +-+-+ +-+-+
!   ! ! !   ! !       !   ! !   !       ! !   ! !     !     !
+ +-+ + +-+-+ + +-+-+ +-+-+-+-+ +-+-+ +-+ +-+-+-+ +-+-+-+-+ +
!   !       ! !     !       !   !   !   !     ! !         ! !
+-+ +-+-+-+-+ +-+-+-+-+-+-+-+ +-+ +-+-+-+-+-+ + + +-+ +-+ +-+
!           !               !           !   !   !   !   !   !
+ +-+ +-+-+-+-+ +-+-+-+ +-+-+-+-+-+-+ + + +-+-+-+ +-+ +-+-+-+
!   !         !       !     !         !     !   !   !       !
+ +-+-+-+ +-+-+-+ +-+-+ +-+-+-+-+-+-+-+-+-+ + +-+-+ + +-+-+-+
!       !       !   !                     !       ! !       !
+ +-+-+ +-+-+-+-+-+-+-+-+-+ + +-+ +-+-+-+-+-+-+ +-+ +-+-+ +-+
!     !         !         ! !   !             !   !     !   !
+ +-+-+-+-+ +-+-+ +-+-+ + + +-+-+-+-+ +-+-+-+-+-+-+ + +-+-+-+
!         !           ! ! !         !             ! !       !
+ +-+-+ +-+-+-+-+-+-+-+ +-+-+-+-+-+-+-+-+-+-+-+-+-+ +-+ +-+-+
!     ! !             !                           ! !       !
+ +-+-+ + + + +-+-+ +-+-+-+-+-+-+ +-+-+-+ + +-+-+-+ +-+-+-+-+
!     !   ! ! !           !   !         ! !       !         !
+ +-+-+-+-+-+-+-+-+-+-+ +-+ +-+-+-+-+ +-+-+-+-+-+-+-+-+ +-+ +
!                     !             !     !           !   ! !
+-+ + +-+-+-+-+-+-+ +-+-+-+-+-+-+-+-+-+ + + +-+-+ +-+ +-+-+ +
!   !             !                   ! !       ! !       ! !
+ +-+-+-+ +-+-+-+-+-+-+-+ + +-+ + +-+-+-+-+-+-+ +-+-+-+-+-+-+
!       !               ! ! !   !           !               !
+ +-+ +-+-+-+-+-+-+-+-+-+ +-+-+-+-+-+-+ + +-+-+-+ + + +-+-+-+
!   !                   !           ! ! !       ! ! !       !
+ +-+ +-+ +-+-+-+-+ +-+-+ + +-+-+-+-+ + +-+-+-+-+ +-+-+-+-+-+
!   !   !       ! !   !   !         !           !           !
+ +-+ +-+-+-+-+-+ +-+ + +-+-+-+ +-+-+-+-+-+-+-+-+ +-+ +-+-+ +
!   !           !     !     !                   !   !     ! !
+ +-+-+-+ +-+ +-+-+-+-+-+ +-+-+-+-+ +-+-+-+-+ +-+-+ +-+-+-+-+
!       !   !           !         !     !   !     !         !
+ +-+-+-+-+-+-+-+ +-+-+ +-+-+-+-+-+-+ +-+ +-+-+ +-+ +-+-+-+ +
!       !       !     !             !         ! !         ! !
+ +-+-+ + +-+-+-+-+-+ +-+-+-+-+-+-+-+-+-+-+-+-+-+ +-+-+-+-+-+
!     !             !                           !           !
+ +-+-+-+-+-+-+ +-+-+ +-+-+-+-+-+-+-+-+ +-+-+-+-+ +-+-+-+-+ +
!             !     !             !             !         ! !
+ +-+ +-+-+-+-+ +-+-+-+-+-+-+-+-+-+-+-+-+-+-+-+-+ +-+-+ +-+ +
!   !         !                                 !     !   ! !
+ +-+-+-+-+ +-+-+-+-+ +-+-+-+-+-+-+ +-+-+-+-+-+-+-+ +-+-+-+-+
!     !             !             !               !         !
+ +-+-+-+-+-+-+-+ +-+-+ + +-+ +-+-+ +-+-+ +-+-+ +-+-+-+-+-+-+
!   !         !   !     !   !   !       !   !               !
+ + + +-+-+-+-+-+-+ +-+-+-+-+-+-+ +-+-+ +-+-+-+-+-+ + +-+-+ +
! !               !       !           !           ! !     ! !
+ +-+-+ +-+ +-+-+ +-+ +-+-+ +-+-+-+-+ +-+ +-+-+ +-+-+-+-+-+ +
!     !   !   !     !     !         !   !     !           ! !
+ +-+-+-+-+-+-+-+-+-+-+-+-+-+-+-+ +-+-+-+-+-+-+ +-+ + + + +-+
!                               !             !   ! ! ! !   !
+ +-+-+-+-+-+-+-+-+ +-+-+ +-+-+-+-+-+-+-+-+-+-+-+-+-+ +-+-+-+
!                 !   !                             !       !
+-+-+-+-+-+-+ +-+-+-+-+-+-+-+-+-+-+-+-+-+-+-+-+-+-+-+-+-+-+-+
