+-+-+-+-+-+-+-+-+-+-+-+ +-+-+-+-+-+-+-+-+-+-+-+-+-+-+-+-+-+-+
!                                                           !
+ + +-+ +-+-+-+-+ +-+-+-+-+-+-+-+-+-+-+-+-+-+-+-+-+ + +-+ +-+
! !   !         !                               !   ! !     !
+ +-+-+-+ +-+-+-+-+ + +-+-+-+-+-+-+ + + +-+-+-+-+-+-+ +-+-+-+
!       !       !   !         !     ! !           ! !       !
+-+ + +-+ + +-+-+ +-+-+-+-+-+-+ +-+-+ + +-+-+-+ +-+ +-+ +-+ +
!   !   ! !     !             !     ! !     !     !       ! !
+-+ +-+-+ +-+-+-+-+-+-+-+-+-+-+ +-+ +-+-+-+-+-+-+-+-+-+-+-+ +
!       !                     !   !   !                   ! !
+ +-+ +-+ +-+-+ +-+-+-+ +-+ +-+-+-+-+ + +-+-+ + +-+-+ + +-+-+
!   !   !     !       !   !         !   !     !     ! !     !
+ +-+ +-+ +-+ +-+-+-+ + +-+ +-+-+ +-+-+-+ +-+-+ + +-+-+-+-+-+
!   ! !     !       ! !   !     !     !       ! !           !
+ + +-+ +-+-+-+ +-+-+-+ +-+ +-+-+-+-+ +-+-+ +-+-+-+-+-+-+-+-+
! !   !       !       !   !         !     !                 !
+ +-+-+ + +-+ + +-+-+-+-+-+ +-+-+ + +-+-+-+-+ +-+-+-+-+-+ + +
!   !   !   ! !       !   ! !   ! !         !     !       ! !
+-+ + +-+ +-+-+-+-+-+-+ +-+ + +-+ +-+-+-+ +-+-+ +-+ +-+-+-+ +
!   !   !             !     !           !     !   !   !   ! !
+-+ +-+-+ +-+-+-+-+ +-+-+-+-+-+-+-+-+-+-+-+-+ +-+-+ + + +-+ +
!       !         !                   !   !       ! !     ! !
+ +-+-+-+-+ +-+-+-+-+-+-+-+-+-+-+-+-+-+-+ + +-+ +-+-+-+-+-+-+
!         !   !                         !     !             !
+ +-+-+-+ + +-+ + +-+-+-+-+-+-+-+ +-+ +-+-+-+-+-+-+-+-+ +-+ +
!     !   !     !               ! !                 !   !   !
+ +-+-+-+-+-+-+-+-+ +-+ +-+-+-+-+ + +-+-+ +-+-+-+-+-+ +-+-+-+
!             !       !         ! !     !         !         !
+-+ +-+ +-+ + + +-+-+-+-+-+ +-+-+-+ + +-+-+ + +-+-+ +-+-+-+-+
!   !     ! ! !         !         ! !     ! !     !         !
+ + +-+-+ +-+-+ +-+ +-+-+-+-+ + + + +-+-+ +-+ +-+-+-+-+ +-+-+
! !     !   !   !       !     ! ! !     !   !         !     !
+-+ +-+-+-+ + +-+ +-+ + +-+-+-+ +-+-+-+-+ +-+-+-+-+-+-+ +-+-+
!         ! !   ! !   !       !         !             !     !
+-+ +-+-+-+-+ +-+ +-+-+-+-+-+-+-+-+-+-+-+ + +-+ + +-+-+ + +-+
!           ! !                         ! !   ! !   !   !   !
+ +-+-+-+-+-+ +-+-+ +-+-+-+ +-+-+-+-+-+-+ + +-+ +-+-+ +-+-+-+
!           !     !     !               ! !   !     !       !
+-+ +-+ +-+-+-+-+ +-+-+-+-+-+ +-+-+-+-+-+ +-+ + +-+-+-+ +-+ +
!     !         !           !         !     ! !       !   ! !
+ +-+-+-+-+-+-+-+-+ +-+-+-+-+-+ +-+-+-+-+-+-+ +-+-+-+ +-+ + +
!                 !       !                 !       ! ! ! ! !
+ +-+-+ +-+ +-+-+ +-+ +-+-+-+-+-+-+-+-+-+-+-+ +-+-+-+ + +-+-+
!     ! !       !   !                       !       !       !
+-+ +-+ +-+-+-+ +-+ + +-+-+-+ +-+-+-+-+-+-+-+-+-+ + +-+-+ + +
!     !       ! !   !       !                   ! !     ! ! !
+ +-+ +-+-+-+-+-+ +-+-+ +-+-+-+-+-+-+-+-+ +-+-+-+-+-+-+-+-+-+
!   !       !         !             !   !                   !
+ +-+-+ +-+-+-+-+-+ +-+ +-+-+ +-+-+ +-+ + +-+-+ +-+-+-+-+-+-+
!     !     !   !     !     !     !   !       !             !
+ +-+-+-+-+ + +-+-+-+ + +-+-+ +-+-+-+ +-+-+ +-+-+-+ + +-+-+-+
!         !         ! !   !       !       ! !       !       !
+ +-+-+ +-+-+-+-+-+-+-+ +-+-+-+-+-+-+-+-+-+-+-+-+-+-+ +-+ +-+
!     !               !                             ! !     !
+ +-+-+-+ +-+ +-+-+-+-+ +-+ +-+-+-+-+ +-+-+-+ +-+-+-+-+ +-+-+
!       !   !         !   !         !       !     !         !
+ +-+-+-+-+ + +-+ +-+-+-+-+-+-+-+-+ + +-+-+-+ +-+-+ +-+-+-+-+
!         ! !   !                 ! !       !     !       ! !
+ +-+-+-+-+ + +-+-+-+ +-+ +-+ +-+ +-+-+-+-+-+-+-+-+-+-+ + + +
!     !     !       !   !   !   !                     ! !   !
+-+-+-+-+-+-+-+-+-+-+-+-+-+-+-+-+-+-+-+-+-+-+-+-+ +-+-+-+-+-+
