+-+-+-+-+-+-+-+-+-+-+-+-+-+-+-+-+-+-+-+-+-+-+-+-+-+-+-+ +-+-+
!                                                           !
+ +-+-+-+-+ +-+-+-+ +-+-+-+ + +-+-+-+-+-+ +-+-+-+ +-+-+-+-+ +
!         !       !     !   !           !   !             ! !
+ +-+-+-+-+-+-+-+-+ +-+-+ +-+-+-+-+-+ +-+ +-+-+-+-+-+-+-+-+ +
!                 !     !           !   !                 ! !
+ +-+-+-+-+-+-+ +-+ +-+-+-+-+ +-+-+ +-+-+-+-+-+ +-+-+-+-+-+ +
!             !   !         !     !           !           ! !
+ +-+-+-+-+-+-+-+ + +-+-+-+ +-+-+-+-+-+-+-+-+-+-+-+-+-+-+-+-+
!               ! !       !     !                           !
+ +-+-+-+-+ + + +-+ + + +-+-+ + + +-+-+-+-+-+ + +-+-+-+ +-+-+
!       !   ! !   ! ! ! !   ! !       ! !     !       !     !
+ +-+ +-+-+-+-+-+ +-+ +-+ + + +-+-+ + + + +-+-+-+ +-+-+-+-+-+
!   !         !     !   ! !       ! !   !   !               !
+ +-+ +-+-+-+-+-+-+ +-+ +-+-+-+-+ +-+-+-+-+-+-+-+-+-+-+ + +-+
!   !             ! !           !                   !   !   !
+-+ +-+ +-+-+-+-+-+ + +-+-+ + +-+-+-+-+ +-+-+ +-+-+-+ +-+-+-+
!     !     !     ! !     ! !         !   !         !       !
+ +-+-+ +-+-+ +-+-+ + +-+-+ +-+-+-+-+-+-+-+-+-+-+-+ + +-+-+ +
!     !       !     !     !                       ! !     ! !
+-+ + +-+-+-+-+-+-+-+ +-+ +-+-+ +-+-+-+ +-+-+-+-+-+-+ +-+-+-+
!   !               !   !     !       !           !         !
+-+ +-+ +-+-+-+-+-+-+ +-+-+-+-+-+-+-+-+-+-+ +-+-+ +-+-+-+-+-+
!     !             !           !         !   !             !
+ + +-+ +-+ +-+-+-+-+ +-+-+ +-+-+ +-+-+-+ + + +-+-+-+ +-+ +-+
! !   !   !       ! !     !     !       ! ! ! !     ! !     !
+ +-+ +-+ +-+-+-+ + +-+ + +-+-+ + + +-+ + + +-+-+ +-+-+ +-+ +
!   ! !         !   !   !     !   !   ! ! !     !         ! !
+ +-+ + +-+-+-+ +-+-+ +-+-+-+-+-+-+ +-+-+-+ +-+-+-+-+-+-+ +-+
!   ! !       !     !           !   ! !                 !   !
+ +-+ +-+-+-+-+ + +-+ +-+-+-+-+-+-+-+ + +-+-+ +-+ +-+-+ +-+-+
!   !         ! !   !       !       !     !     !     !     !
+ +-+ +-+-+ +-+-+-+ + +-+-+ + + +-+-+-+-+-+ +-+-+ +-+-+-+ +-+
!   !     !   !   ! !     !   !         !       !       !   !
+-+ + +-+-+-+ + +-+ + +-+-+-+-+-+-+-+-+-+-+-+-+-+ +-+-+-+-+-+
!   !       !     ! !               !           !           !
+-+ +-+-+-+-+-+-+-+ + +-+ + +-+-+-+ + + +-+-+-+-+-+-+-+ +-+-+
!                 ! !   ! !       !   !           !   ! !   !
+-+ + +-+-+-+-+-+-+ + + + +-+-+ +-+-+-+-+-+-+-+ +-+ +-+ + + +
!   !           !   ! ! !     !               !       !   ! !
+ +-+-+-+-+-+-+ + +-+ + + +-+-+-+-+-+-+-+-+-+-+-+-+-+ +-+-+ +
!           !   !   ! ! !                           !     ! !
+ +-+-+-+ +-+-+-+-+-+ +-+ + +-+-+-+-+-+-+-+-+-+ +-+-+ +-+ + +
!       !         !     ! !                   !     ! !   ! !
+ +-+-+ +-+-+-+-+ + +-+-+ +-+-+ +-+-+-+ +-+-+-+ +-+ + +-+-+-+
!     !     !     !     !     !       !       !   ! !       !
+ +-+-+ +-+-+ +-+-+ +-+ +-+ +-+ +-+-+-+-+ +-+-+-+ +-+-+ + + +
!     !     !     !   !   !   !         !       !     ! ! ! !
+-+ +-+-+-+-+ +-+-+-+-+-+-+-+-+-+-+-+-+-+ +-+-+-+ +-+-+-+-+-+
!         !                             !       !           !
+ +-+-+ + + +-+-+-+-+ +-+-+-+ +-+-+-+ +-+-+-+-+-+-+ +-+-+-+-+
!     ! ! !         !     !         !     !       !         !
+ +-+-+ +-+-+ +-+-+-+-+-+-+ +-+-+-+-+ +-+ + +-+-+-+-+-+ +-+-+
!     ! !                 !         !   !             !     !
+-+-+-+-+ +-+-+-+-+-+ +-+-+-+-+-+-+-+ +-+-+-+ + +-+ +-+-+ +-+
!                   !             !         ! !   !     !   !
+-+ +-+-+-+-+-+-+ + +-+ +-+-+-+-+-+ +-+-+ +-+-+ +-+-+ +-+-+-+
!               ! ! !             !     !     !     !       !
+ +-+-+ +-+-+ + +-+-+-+-+ +-+-+-+-+-+-+-+-+-+-+-+-+ +-+-+-+-+
!     !     ! !     !                             !         !
+-+-+-+-+-+-+-+-+-+-+-+-+-+-+-+-+-+-+-+ +-+-+-+-+-+-+-+-+-+-+
